"filename", "language", "JSON", "HTML", "JavaScript", "comment", "blank", "total"
"d:\Proyecto-de-grado\client\public\index.html", "HTML", 0, 20, 0, 0, 4, 24
"d:\Proyecto-de-grado\client\public\manifest.json", "JSON", 20, 0, 0, 0, 1, 21
"d:\Proyecto-de-grado\src\app.js", "JavaScript", 0, 0, -42, -8, -15, -65
"d:\Proyecto-de-grado\src\config.js", "JavaScript", 0, 0, -1, 0, 0, -1
"d:\Proyecto-de-grado\src\controllers\auth.controller.js", "JavaScript", 0, 0, -82, 0, -18, -100
"d:\Proyecto-de-grado\src\controllers\author.controller.js", "JavaScript", 0, 0, -52, 0, -10, -62
"d:\Proyecto-de-grado\src\controllers\carrera.controller.js", "JavaScript", 0, 0, -13, 0, -6, -19
"d:\Proyecto-de-grado\src\controllers\tasks.controller.js", "JavaScript", 0, 0, -91, -1, -20, -112
"d:\Proyecto-de-grado\src\controllers\upload.controller.js", "JavaScript", 0, 0, -14, -1, -2, -17
"d:\Proyecto-de-grado\src\db.js", "JavaScript", 0, 0, -9, -16, -3, -28
"d:\Proyecto-de-grado\src\index.js", "JavaScript", 0, 0, -6, 0, -3, -9
"d:\Proyecto-de-grado\src\libs\jwt.js", "JavaScript", 0, 0, -17, 0, 0, -17
"d:\Proyecto-de-grado\src\middlewares\validateToken.js", "JavaScript", 0, 0, -12, 0, -2, -14
"d:\Proyecto-de-grado\src\middlewares\validator.middleware.js", "JavaScript", 0, 0, -8, 0, -1, -9
"d:\Proyecto-de-grado\src\models\author.model.js", "JavaScript", 0, 0, -42, 0, -2, -44
"d:\Proyecto-de-grado\src\models\carrera.model.js", "JavaScript", 0, 0, -22, 0, -4, -26
"d:\Proyecto-de-grado\src\models\project.model.js", "JavaScript", 0, 0, -42, -1, -5, -48
"d:\Proyecto-de-grado\src\models\user.model.js", "JavaScript", 0, 0, -27, 0, -3, -30
"d:\Proyecto-de-grado\src\routes\auth.routes.js", "JavaScript", 0, 0, -18, 0, -4, -22
"d:\Proyecto-de-grado\src\routes\author.routes.js", "JavaScript", 0, 0, -17, 0, -3, -20
"d:\Proyecto-de-grado\src\routes\carrera.routes.js", "JavaScript", 0, 0, -6, 0, -4, -10
"d:\Proyecto-de-grado\src\routes\projects.routes.js", "JavaScript", 0, 0, -23, -1, -6, -30
"d:\Proyecto-de-grado\src\routes\upload.routes.js", "JavaScript", 0, 0, -5, 0, -3, -8
"d:\Proyecto-de-grado\src\schemas\auth.schema.js", "JavaScript", 0, 0, -35, 0, -2, -37
"d:\Proyecto-de-grado\src\schemas\author.schema.js", "JavaScript", 0, 0, -22, 0, 0, -22
"d:\Proyecto-de-grado\src\schemas\task.chema.js", "JavaScript", 0, 0, -16, 0, 0, -16
"Total", "-", 20, 20, -622, -28, -111, -721